XXXXXX
XGGCGX
XGB..X
XX.B.X
XXB.XX
XPB.X.
XX..X.
.XXXX.