..XXXXX.
XXX...X.
XGPB..X.
XXX.BGX.
XGXXB.X.
X.X.G.XX
XB.CBBGX
X...G..X
XXXXXXXX