XXXXXXXX
XG...B.X
XGB..X.X
XGX.X..X
XXX.X.XX
.X.B..X.
.XP.XXX.
.XXXXX..