....XXXXX.
XXXXX...X.
XGG.B.B.XX
XGGB.B..PX
XXG.BXX.XX
.XXX....X.
...XXXXXX.