.XXXXXXXX.
XXGGX...X.
X.GGX.B.XX
X.P.B..B.X
XXBXXX...X
.X.....XXX
.XXXXXXX..