XXXXXXXXXXX
X.....X.P.X
X.B..B..B.X
XX.XGGGX.XX
.X.XGGGX.X.
.XB.XXX.BX.
.X...B...X.
.X..XX...X.
.XXXXXXXXX.